.......                
-------                
....... .......        
-----   -------        
..... .............    
---   ----###------    
..... .....#.......    
-----   -----------    
....... ....... ...    
DDDD---         ---    
DDDD...................
  DD-------------------
  DD...................
              -------  
              .......  